root: 
cwtl: wqpn: 
gprl: whnr: zcdv: hdtw: 
qbgv: jhzp: sqwc: qbpl: qfmd: wntp: 
pvmv: rnqm: tmtb: bcjw: vrhf: vdql: tbnq: sjhs: tsfb: vhbg: 
ncfn: ctdz: vvhw: bwzc: gtgz: fpjw: whsm: crbv: pwss: zvvw: mfjc: nwcz: jgfc: vcdt: fwvn: jnst: 
zdnq: vdzv: hsnj: ztmz: wgqg: nvbw: gbmc: dsnf: rtvs: zbhv: thbn: spfj: ptvr: qcbt: jhdb: vsbp: gnqc: sfsh: bndp: mjsd: dgvb: jmfh: lfqv: vmsm: ppmm: mrbr: 
vzjg: nqhq: nrpt: ljlg: vdws: zdhd: cvfs: cjrt: snzv: tmqq: wssq: vszq: mtmn: pbvb: pdbq: ndhf: wqbh: mhcl: bqlm: cmgr: sbht: qfzb: psmd: dwbd: fbbt: lncq: qsfc: qpnw: mdtd: qfsq: zlrz: qdss: gqpf: zmtf: rtrm: pzbg: fjbt: bvdn: 
pcdm: hcwm: gjpl: zdbf: ftvr: pqnh: hjvv: fspz: gbtd: qbng: ffpb: rpmf: qlsw: bgqs: pfzs: rzsh: dqrs: cbqg: mlnh: tjvd: jqcq: hnqg: wngv: ffdg: tdvn: gwnl: sdpl: nqdr: vdvf: frqg: tpmm: jcsc: dqgd: dhwp: hgrg: bpsw: ppvw: wggh: jshn: jzwf: hpdr: ntdv: swbd: dlqr: nqlj: gmjt: tbqh: mvwr: wccj: rvww: 
rdws: hmlb: qnbz: nfjw: cczt: fcwl: bvpb: cwvn: pbjw: whcr: gbdf: vzzh: pwbn: fhbb: jcsj: pmmz: qlhn: ngnz: wrsw: qrsh: wvqh: prcw: ntlc: tdgg: wjvn: vzhq: gdrq: rfbp: hvgw: rfhf: dfpc: nphq: whwm: wngb: hgpb: mhbp: clwr: nllr: pdlg: crlm: mfjg: dwjd: wbqv: bhgh: vmbp: lhpr: httg: tvzh: nttg: rcpf: fvnm: qnlq: vddp: hfgw: ljqs: qgqt: 
pcbw: fjnf: qzrj: wvjz: zqnn: mbvt: gpzc: znhg: jwqs: fjtf: hrdq: glzz: rpsm: czfc: snfs: qqdf: nvzh: pvbm: jvjr: mfwz: pgsz: gqpl: pcwf: wbrs: smzg: cfsp: hdnq: rznc: mwpv: wmlf: ggtv: tzjc: qjww: cmlg: wtzw: bwvh: vjpz: qvcf: srdb: hfqn: wdbb: gshm: jpnr: tvgm: zpvn: jzcp: jhwf: znbg: dvcm: qhtc: mrqw: qhjc: mjsr: bmwg: ljmh: hzzl: zbhg: pqsd: ddsh: nvrn: rgwm: frmf: tdgd: dzgf: 
dvql: jjlp: mdfs: mbnf: bdmn: jpwg: bzdb: qctf: lrgz: mgfq: zrjh: qvpc: cpdm: nvqt: fnnv: fmhs: lhmb: tswg: fhsr: hfdq: fjrh: cpqm: flws: tbdf: zvbp: wvfc: znhz: fdtg: gpbm: mnmj: hnvr: mfbg: jglz: ttln: qsvl: wqrj: jjrb: bhrc: vtvw: zvfn: nlmq: dvms: zwwp: npzs: fvvt: hjpp: dgfb: pwqt: bqsp: whpp: wgbm: wzgq: drrz: jrps: dbff: mhlg: cztw: mgpq: bdbf: hhcv: tphn: lmbw: rdmp: cwpc: 
mtbg: cslt: mczd: jhdp: wrjf: pqgl: nvgn: vssj: cdsv: tzwh: bqgf: qpff: rzlm: nmfm: lqmz: lmnz: tczm: tjqh: vwsc: hmpd: htlf: ptcr: phbq: wfwc: sdbf: mlwg: nrjh: gnlb: qmss: mdjt: ddrr: qrps: tzcs: qfmj: nnzw: zcdd: whwn: nsgd: qtmv: pbgm: wfcn: jszw: jqcr: mwbl: bjjd: wnch: pqhs: gwgz: hnwq: zlzg: thdn: pdnf: lgwl: gwfs: qpst: gbth: dndw: fjbn: wzvl: sphm: whgq: jwdl: srct: twml: ccwm: vhrl: pfmm: rjtt: qtjw: ctcj: vlsj: nswg: cstd: lglf: tllc: lwhq: bjwm: fllr: chgm: qpln: 
ltqm: rqcz: vqmb: ccrm: wsbb: srtn: plhb: bfzs: zfhw: twhn: grnh: gdjw: llfn: cplb: gmjg: mwvv: shgc: bqzv: fbmb: qztz: vjps: gszw: wqqd: nqwj: lflz: zwbt: tcvc: rbcv: grdq: clwl: rwfv: mhzc: zmgg: mctq: msgg: fqcz: bgvb: vpch: qrsg: bgpc: ljjv: pfnv: pntq: crdg: jhml: wpfz: zwwd: fzls: gdgj: lmwf: twvj: sbnj: lqwp: szdm: pjsc: gqwr: mfbs: zvrh: rfsc: jhjt: bftb: dpnj: srqw: qghp: jmpm: rdvw: vsnn: prnh: snhf: cgtq: lhtl: bvwm: pnwc: wvwh: bjjq: ttnz: tgvq: lqsc: qgmf: nrnc: pdzg: dhqd: svrr: dcbh: gqbp: lqcb: flzq: pfqz: rbmp: dcsb: rlfd: qzhr: vbzg: gpnz: wspn: jpnc: 
pnjs: qjjg: jggh: pdbp: nsvf: mtpj: gjdv: fdsq: fcbs: pjgr: psqz: rfsp: fcrs: qbnd: gsgv: gcfs: wzct: jrmg: qrnp: stfz: mcht: tbmd: nzwv: ljsq: vlgw: lgvw: hqtz: vtbr: qtwr: nhth: crpc: njzw: tvfs: mgrs: hhbf: rwwn: ctdn: fqjn: zgdm: vjrq: hhgr: wpgm: snfb: mfbn: lhll: rhlg: dqrb: srcw: pdcg: srsp: wfgh: rjfj: qtlv: gzfg: nfdl: smtz: dgqz: gdhl: zmrh: rcjw: dmtb: zqhb: jfzb: pwpj: wwvh: dffn: drwb: jsbj: rwfb: wqjt: rszs: zmcw: bthl: cjdh: jwcb: dhsj: gmwv: jftw: pmlv: pgff: hnmd: bbhm: sdjv: zcbm: wcgj: gsdz: qsbl: tcch: qnqw: rjvw: gjpj: fdvl: mzlb: mtdz: bwsj: cvjc: gnbz: fpgb: rbnf: rdrz: zwhw: llcv: wrsf: djzd: pvqm: dhgd: bzrp: bbmw: pbmz: lfhj: scml: nghg: rfbl: vrnw: gsbb: lpvn: 
nnrv: wvdq: bnns: hwlg: tqmz: prsp: wzlh: chpv: ndmz: vdjs: cdls: vspg: pjzb: qwmw: hggq: ncgg: nhjl: gzwl: gqsw: hcsg: bghw: ctgd: zsfh: bvhj: gmvh: bsjb: zzmh: nbth: mcvl: btzm: dbmb: mgns: vzmc: zdzr: lzgl: brlr: vhbm: flrs: pttb: lmgb: ddqj: lrhn: wrjh: mfhw: vdml: wcsc: qwqb: svtq: zpnf: scpn: vdmg: fqbh: qpbz: mscj: cbvv: fqnj: sbgc: rdwl: zdss: pjqd: jlwh: dqwh: ndfj: zzjg: bswt: tqch: rtwq: qqgn: jcff: ffpw: cvzg: zrpj: thrp: wgrs: wmqd: flhp: fsrp: hhgz: gtgn: rght: lmwb: hfnn: blgr: tnfh: nttt: jjjv: cpsq: sfcl: fvbn: hwbb: rbwb: dhzq: hzjt: lnlw: glcn: tvfb: vcgm: jszc: zjmz: hcmw: qbsq: pmbd: rlwz: sdjw: mbvc: vcqg: jhnv: wtgn: bcnf: bwzn: hllc: zcmt: fzcl: jplg: vszh: nmvh: wmbn: jtdn: 
hqpr: qzbh: bdrw: mtjp: cwqh: pflt: wzzd: dlzl: hcsc: qhff: tdrb: hhgm: cbjp: nqsr: pstr: zqdc: fbpf: bhjr: vdqm: ptch: hjlh: ccnm: nvml: grpp: blwt: gdhc: rjvj: qtft: fmrd: tbfd: fhjf: jrtg: vmjq: psvh: ntvs: vbwg: sbcr: ptrl: jcvr: jzmj: btvn: ntfc: nfbd: mbhp: lrtq: rdql: fpzl: ptlp: pljn: njpn: dncs: cfqf: qdgb: srpn: nflf: pqsm: wgzr: gfgf: fpdj: qrnt: hnft: hwpl: stlj: rpwp: fjdj: bmjp: wmzg: hmnl: szsg: trjq: dhmq: cczs: mmbz: nsrl: zbpr: vvfg: nhqm: mflf: ghhf: mhwg: wscd: lftq: vfgn: ghsm: mdhr: ncwv: wzpn: fsrz: pbjg: bhsg: hptc: zbzv: gdrc: wlcd: mfgw: bqhb: zbhn: zsld: jhpm: fnfj: hwrw: gbgh: vcgz: nhjz: mzjw: hlff: sbqh: pfpz: qvfp: bcpt: rlcr: wwnn: qhnl: wggv: wnlv: cjnh: snqd: bbfl: zwlg: phbj: rjdr: rpnn: 
btqn: fsdc: nznh: njzv: blzs: cqcl: bfzz: qvfr: hpfj: nflb: rctp: qvtp: bqmq: njnq: mcgv: sgrg: tnvq: vlzr: nnpd: pjbv: nhfd: nslf: pfwl: lgtp: dwbg: ngtr: szbq: grnw: tjng: tmfd: gpmg: wmjv: tnhb: ncrp: cfgn: wfdv: rrgz: ntld: lzvv: hvql: hspb: nbjl: dhdd: sjsq: pwww: lmzt: chtn: dvzz: vgvf: vzzg: slfv: bchr: snbp: jlbv: nlmd: qmns: bvls: bmfp: rcgn: csdb: wdcs: lzvf: ghnt: wtgh: nsft: npdl: slws: dvfw: rdlh: pssr: fhjd: jmjb: vnch: wnjm: jhfw: nlvp: qllh: zjcb: lltb: bfbq: zpzs: snsq: nznc: cmbm: fstv: bggd: bzmq: nbnp: wdzl: gzzs: gpsl: shff: tlds: zmdw: bmlr: jgcr: rdmw: dlqn: wclz: jdjf: wqzc: wnrb: nzjm: pvqg: qqpc: bsjg: dgwp: srrn: zwgt: whcc: zgcq: dsmv: mqrc: jwlz: dftd: jtzt: tlgs: ztsr: wnzd: cnpc: hrmq: dldm: fftj: rnpp: 
lzlr: qfng: nvth: hmtq: bdzj: qnpm: qwrv: bjgq: grbh: mbtl: vndq: npph: fwqf: chmz: zvjn: hhft: cwqn: wptt: frcf: wtbh: dddg: ldlh: cfhh: jnhv: jmqn: sqmg: chgc: flql: hlgb: wtdm: wrqv: fvlw: gdhj: fbbc: tjrz: nnfl: jsnr: lsgl: lqdz: mzpl: nrqc: tfvp: wfmt: jrcw: mppm: fstd: smnj: bqvm: vlbr: fvvh: spsb: ctjj: pcjl: wncv: cjlz: vbrv: pwfc: gsnr: nftd: sfzl: dfzr: wvpv: vdzq: tfzd: cpqr: mqtd: fdpn: gbmt: rcwb: cvqw: lsjd: jgzh: jpvs: mlsj: tcdz: qrmn: qrtt: qpnn: mhwb: bcpf: psct: wwjb: tpvt: jhgb: fmqr: qqcb: npmt: gcgb: wdpf: rzfw: zvzt: gfdf: zhzq: jqqc: bsff: nfsq: lgfh: frzt: dzql: wvvf: htfn: ptzp: ndwq: rnnt: vhvn: hvvw: gjjz: twhm: wwjt: mrdr: wrqq: wvhs: nzgj: vtfs: mqqz: hmnq: vwfc: vcvv: gwdh: cqjf: 
qntm: dqzt: sphb: dmgj: gpzm: tszz: tvpc: tmfz: trgs: ctjw: vcdj: sfhl: jzhz: hzjs: jdmz: zwrg: qmnt: lbpc: vljb: tmqs: llqd: sglb: qssg: gdfn: lgzt: vvrz: qjzv: lgnb: jqlz: lzsf: pjhn: bthf: lspg: gnsn: jrtf: bsmr: hnrs: ndld: sgbt: cscj: fbrs: svgd: dcpw: tvbn: tbsn: sbwn: rhpz: djzj: nqrw: mmvq: mfbp: lgpn: clcw: hqsl: lhhb: bjps: dqhs: djtr: hplm: cdhc: gcqm: cjdd: mnds: zcfc: jzgd: mfgq: rzps: gsdr: sdnn: mznv: fcsb: scvq: lfdj: qsjm: lzcq: msvq: rqbl: hprr: qfln: pflg: rmwq: dntt: swzp: crgj: rvbm: jnmf: pccl: dslw: snzz: svfv: jjqr: hpfl: qbjl: pffl: bfnr: bbwz: wmfd: tpcz: jwbf: znnv: wtdw: zhgr: nlzl: fthz: nrwc: jzjw: vvtw: vbhj: cdvg: nmfn: jpnd: wtqw: mhjl: bfgj: fdtn: nntd: vzdw: tjpr: wrmj: nqtb: 
llvp: rwjh: mpqd: qrfp: swfb: hlrd: hjzn: mqtv: gqdf: htbb: qgwz: wtdc: vlqt: sdgr: szfw: tbdd: bvcw: cnsf: ngfd: hhgl: stgr: zftd: lzhd: bhsj: rrsw: fwtb: nmrh: lhvt: lwgr: qgpd: dtwv: tppb: fmqf: pgrl: lfnd: vbcw: nlwp: cbtb: wmgp: nzlf: dcwd: cmws: ldqf: qrvc: hwgv: nljn: jghr: vszc: cjqn: lpqt: jspg: dwfh: zwsg: ctvv: dgbl: zlnq: qwqw: mlfp: hpbs: lmvn: wzpm: cnwd: dcjj: zmrd: slzn: spst: scpf: ggrh: chzz: llzm: jlbz: crvv: wmbl: tsgd: mhpg: zbnc: djnw: lbqj: jlzq: qvwc: rddd: cbmm: fpcq: nncm: cmwr: tqsl: wthv: qczc: bwqg: mfsb: jcpz: msvz: nhlv: tndh: whll: srpf: qgpq: nbwq: spln: dsnv: qjfl: gfsm: vpvl: nlvn: phjv: dqwf: 
gmbl: bpvt: gtss: srss: hlnq: pvpd: zgvl: tdrg: bfgs: pfgp: pzhl: bcsb: mmqs: gqjj: ghzl: zjfc: hjvp: cszl: cmhq: rvcs: trsc: pjwv: nzjv: lqgh: hmbb: ffsh: dprv: njtd: pwqz: bbwl: gnbm: tcdc: rdbj: qgfm: snzm: vzvc: fhpw: njws: dnqd: bsrc: dpqt: hvgr: tbjc: tlcg: vvtm: dbqs: bglj: grqn: jgjf: vmrt: rpgb: ltbf: tndq: bszl: fbrp: gdrd: plrn: qrgg: nhwg: bhsc: tbzw: gscq: wsvh: nmls: nrhz: wvrq: dvtz: qqqp: rjgc: bngj: trtg: dnmp: dmzh: gpdq: rngm: rptd: wvzz: nbbt: hfpd: jmqm: nrtl: rnrv: ctsj: jvwn: ggmn: pwzg: wsrr: prcb: gljv: vgzj: brrc: wswz: dqsj: nnvg: jjss: jwlq: qqnl: zbwm: znhm: hdph: wgrr: tnrr: 
mljl: bcpz: gtpl: mlnp: bnrc: dfcw: ndvm: zfdc: vbsd: sdhf: ldhj: bvrp: rpfm: pzvh: dtlf: vbsq: hgfd: cslf: nsvh: wszg: jqtw: pbfb: pbnt: hjrm: mmjl: tdqj: tghw: cpdj: jmvn: fdpt: rfbh: nlpb: qsnt: rcsw: shgf: dvlr: lqwh: fdnb: htjw: cmnl: cdgh: ctwq: ljgc: gngz: wrvm: ppcf: htct: sgnb: dvwl: sgvt: bmvf: bfrt: llvn: pbpp: rmhb: zdzq: zrtt: nnmt: gsjp: hbdm: lvnw: jjfb: pdhs: bvvc: 
cdnp: vjsj: hdtj: sswp: rjqf: hmbv: tqmv: fwcp: cndv: ggtm: dhjr: cbcf: rrbd: fsqj: tgsv: pdmj: rgnf: hmln: mzzc: jmpp: qvdl: qjfr: wccd: czcj: pght: hjnf: tpnv: bswq: nzsn: gsht: vqgh: dtsr: qlrn: drpm: nsbn: jwwz: lfhp: scfn: nqvp: tnmw: zmvc: tlzb: hrgr: pzzs: jdmn: gpfd: rdfb: wtgf: 
ssjm: dsrh: nbbc: qhhn: dqbg: fnhs: rtnq: wpgc: wbmd: qnzs: mlwb: gstn: rfwf: hghn: hblc: grcq: hncv: vwpq: ffrw: bftt: 
tgnd: tnqq: ctzf: tjzf: rpgr: lfmj: vdvr: zfqh: hvtb: rcpd: qbzr: lvlv: wbts: vrtq: lscf: jcht: 
ghct: stld: grwc: pglf: wrtr: wpqs: bdrs: zslz: nfsl: bbmd: fvtz: lcwc: rrnt: bsjr: 
vhcf: nqcg: zpnl: jtjc: hcnl: jjcv: mzqr: bwwv: nhrt: zptt: sdvg: zjnb: zwjr: lnpp: zqmq: vgqg: dmgc: pljv: dcwc: mwhd: 
zcrq: hvnl: rvzl: zcfr: llsv: tsvw: dtqn: szhd: zphw: cvlw: jtvw: mdzh: hfcn: jcjb: sfhm: hlql: dpwb: qvrv: nwsl: pgcs: vqhg: znwn: 
dgwg: vfjq: sdcs: mfvj: hnbm: zqhw: qwlc: pwmv: dmjf: hnsh: bgvs: rnfh: sbqg: sqjc: rlvv: lsgg: rtvp: mpcm: thbq: tvql: nllh: gnlr: bsmg: vsjs: nqvw: ccpw: whpc: sgmj: 
zrtn: dmqn: gccn: lprr: tmgv: ldgr: hgqm: zwhr: qwrb: mzcl: zlrd: qwqg: pdmz: wqsf: jhpf: fvjj: tzhm: sgsh: vpcg: mlcg: nqpw: jgfb: 
prpz: mczs: dzhc: cqms: cnzs: sfvt: vvtc: spvs: lcpb: sgqn: nvqr: vblw: gcqw: fntt: gcgj: wtft: cbbb: rfct: btdv: hllz: jqzb: gqtd: zdgc: pvfl: 
zcfj: hnlw: bbwq: cfvj: whpv: vqpl: lqwr: ggcw: smns: mgws: hrjr: hcql: mbff: wnrr: ghdg: mlbd: qzlb: vvnr: tdgc: npgz: wnhv: twsh: gqbd: cbtf: fzjn: chnw: fzbb: nscz: 
dfsh: nfhz: vpcb: pzvb: wpgp: spnd: nhww: hhtp: mtjf: wctc: mlzt: tnjz: wpsc: bgjv: hvlz: pfgr: dpzq: lldr: fvtv: ztsg: nqmd: pfsl: zgqn: sftc: 
mjhg: wsvj: hwbr: tpdq: jsqp: gwcq: hmhm: hpgl: scmm: ntsh: mchl: szds: gdwq: csvt: zwqm: hdqn: bgpm: vswd: vmmb: zszf: 
hhpq: lvrz: tjbd: qgpr: cqgb: ldrm: nnqw: wdqz: rlts: rvjq: nmmj: cvls: tnrj: ndmt: 
snfv: clzr: fffv: jtpl: dnst: sjtp: tdsq: hdll: nlnf: wmmj: zcjf: vgzr: 
fhnd: sdrt: mtvq: lgnv: zfvq: lsts: fvpb: sppp: qdgq: trpn: tpqf: wspw: ztjm: zwms: dzqf: pnfn: 
wbfz: jbpq: wmfj: fldv: wtrq: tdjw: cmbv: chrm: cdgn: rrbn: qbbv: lbws: sgjh: plpc: mvth: phlh: pwrl: hfsq: 
gcbm: lrsb: bntb: jbjc: dnbb: nbfq: bncd: zhcj: zczj: mmlj: gmsc: zmct: lsmb: mtpd: pzqs: vfgd: qntj: ltcz: dhrw: bndv: vzws: msgd: fgsc: vnjb: zntc: qzsc: fqgm: qctm: 
cjdb: dgbf: swfp: gcws: qzgb: rvps: jghv: wsbp: lhln: vpvb: qwzw: rrlr: mmfs: sgtf: rvgf: jsvv: mtvg: crqr: 
hgpw: hnsn: zvdr: ptfl: hptp: nfvn: crdr: srwf: dhfl: lvjp: mwcz: dvln: sbgm: dqrd: hfjw: hmcv: 
rpjh: ghvb: rggr: rldp: chzq: mwbs: tbjg: rshd: rmrl: fpwt: vtdd: vqhz: qdvp: sjpj: 
jhcw: vfsz: gdsb: qwhs: gqfd: dpgf: wjvt: fjfz: qjvh: prtn: hzvq: pgzw: 
rqzf: hsfl: dgnn: bchq: chqs: rcnn: wqrw: wrhb: lhlm: rtsd: zspw: grjb: pdfm: nwfb: zclm: nvqd: tpht: stpr: 
gqtq: qdzh: bdmv: vvdq: rspv: lgdh: pqrd: zwhm: nnvt: ldgp: drbd: vhjj: zgfl: cwpd: 
bhwj: nrjj: tlvl: jlbw: qntz: pmzp: gjzm: qrzs: 
nstm: pcvd: pqpl: ndsb: wsqq: wfch: bjhp: drcq: 
zhlb: jznl: vrwp: zrds: cjzm: dmbm: gcls: prcl: 
gmhz: hwjt: gqrw: vjbb: jrsl: dsjl: 
njrb: vfzp: nmjj: ljdb: vjqq: fhnj: 
hqlp: lwsq: zgcz: htzh: vztc: ztdj: qchw: wzbq: 
cpfr: wbgm: hwwj: jpdl: dhzf: qnvs: cpzq: lnhr: jjhj: qhjw: 
wwvz: crhc: pzgg: fcdf: jbnp: bbsc: grwq: vgjg: 
jfln: wzrc: qdnt: lllq: hjgw: spzw: bjsz: cvln: hrbb: vwwc: wvzm: wqzh: 
nrtv: cpgt: hwnz: fgsq: fgpl: thhz: lzvm: ltbv: tgvd: pgbc: psrq: bgcl: qzcf: ldww: zvsf: hbbg: 
ltvf: cttw: wtwj: crdd: dcsf: mrpm: qpzf: bhqz: srjb: pfrz: ptgl: wvjc: bnrb: gdvj: rcqr: rfbf: hcvr: lvdd: vdsh: stfr: 
tnhf: qblw: jnvg: mcwf: hthg: znhd: pcbp: mmgq: frml: mbvl: vcrg: nzjf: gwmq: crpd: gnvn: phpt: thfd: cggg: vlrp: jvnz: cfhz: nscd: 
pmvn: hbbt: zllp: zpsg: zbjz: mdbj: hlvm: fdpw: wnwn: sfng: dqst: pjff: lfsn: dhbz: mrqc: jscb: lbcd: sqwr: dsgc: gpzr: ptfp: cjdq: vzsg: rdwn: 
hsgn: gmrs: ndsj: tncv: qjdg: hrqb: ntjw: hrmm: zgtj: svfw: qzhl: cslr: tqbl: bfzm: hgql: hsmp: dzvb: vbnt: mwsb: hrnj: lvsl: lnnr: lthz: pvcj: zvzq: zhdr: 
lbcc: zqjp: tghv: lftw: ltsm: tmjp: nggf: flsg: sfwr: ndlh: vnzn: mwrj: ppfz: djcq: lzhc: gsvm: vlmp: jcvs: tbrw: vnzr: jjzf: qhbz: tvtg: pbbh: qlmv: tbqw: jslf: cmjz: jczd: qtqr: 
httq: lwzd: wllr: mnsw: bwlr: rdvt: clbj: nwtz: chhf: rmbd: wqhr: rltj: tfbv: dddc: dhjd: lclm: bqbz: btdr: bdqm: ldzl: lwgc: njgq: npqm: nppj: wssz: gbpr: bnsw: bhgv: wwzt: qslw: grdb: ngrh: 
lbtm: mclf: fqln: mqrf: bwhj: blth: vzbv: lmpw: nzwt: dgmq: bbgf: pzsw: fwvg: zgtg: pljt: svcf: fgfw: qmzr: ngpb: nbcp: mfdc: jpgb: qbmt: mzbh: jqng: fdcb: jcdj: mtph: gbhv: fqsm: ffsv: qmcs: pjzm: zsct: bzbg: pjfm: 
vtbj: qdjg: lszg: fmrl: nzpp: hvld: qrqv: qjcn: wmmg: wjjt: zdbb: pqms: wgfl: rmpf: wjtg: dmwf: srms: zvvt: jvhd: dmfq: qffz: vhpb: nwjz: bhfh: wvqr: nlrg: dfzj: fqph: pdrj: glqd: qvmp: mnrq: 
dbjs: vcmw: nbgh: wqth: cwrl: nrzs: ddrh: bvfb: fbtc: rgfq: dncl: wbls: hfrg: bllh: btjm: hqbs: dbpj: ncqc: 
vcrs: gphc: rdnt: fjch: dbwd: wzlt: dmpn: bcrj: ddzd: wjhh: bqnw: hzgg: lmsf: gnnl: rfph: jvrn: qfpm: njgm: lzrr: jfvt: fnfm: lnhv: 
gcdm: cgrz: rmzn: jcmb: sqnl: pqrl: hhfj: qbnt: wbzn: fnbp: bqrf: pzdz: psfj: mrll: mwrw: jblv: fpbl: nnmf: 
bvvr: zcmz: sfzp: mgbh: lptd: cvzz: lvch: ccbn: zjhr: vjmp: lnpw: ctwc: lvrs: nmqh: jjlr: fbcq: lgzj: mrzg: mnfl: qzmr: 
pqwm: tdsb: hhpr: bqjb: bzwm: qdnc: humn: mrjt: lpbn: tlcr: dfhc: qlgd: 
cttf: lzcg: tqmd: thnv: tzlr: rdcv: zhzw: wlqc: fmqz: blzg: dvrh: phwr: fbft: fwsg: 
spqb: zdzw: jmrn: bqwv: mbzb: ccpp: smwp: hbcm: 
mjpz: ndpl: qhgl: ljzg: rszz: hgln: 
169525884255464
